##############################
#M                           #
#                            #
#                            #
#                            #
#                            #
#                            #
#                            #
#                            #
#          c                 #
#                            #
#                            #
#                            #
#                            #
#                            #
#                            #
#                            #
#                            #
#                            #
#                           C#
##############################