#################################################################################
# #       #   #       #   #         # #   #         #   #   # #   #       #     #
# # ### # # # ### ##### # # ####### # # # ### ####### # # # # # # # ### # ### ###
#   #   #   #   # #     #   #     # #   #   #   #   # #   # #   # # #   #   #   #
##### # ####### # # ### # ### ### ### ### # ### # # ####### # ### ### # ### ### #
# # # #   #     #   #   #   #   #     #   # #     #   # #   #   # #   # # #     #
# # # ### # ######### ##### # ############# # ### # # # # ####### # ### # ##### #
#     #   #         # #     #   #   #   # # #   # # #   #       # #   # #     # #
####### ##### ##### # # ####### # # ### # # ##### # ### ####### # ### # ### ### #
#   #   #   # #   #   #   #   #   #   # #   #     #   #   # #   #     #   #   # #
C # # ### ### # ######### # # ##### # # # ### ########### # # ### ####### ### # #
# #   # # #   #     #   # # # #   # #   # #   #         # # # #   # #   #   #   #
# ##### # # ####### # # # # # # # ##### # # ### ####### # # # # ### # # ### #####
# #     #   #   # #   # # # # # # #     # #   #     #   #     #   #   #     #   #
# # ##### ##### # ##### # # ### # # ##### # # ##### # ########### ######### # # #
# # #     #   # #     #   #   # #   #c    # #   #   #     #   #   #       #   # #
# # ####### # # # ### ####### # ##### ##### ### # ##### # ### # ### ### # ##### #
#       #   #   #   # #   # #   #     #       # # #   # # #   #       # # #     #
##### # # ##### # # # # # # ### # ##### ####### # # # # # # # ####### ### #######
#     #   # #   # # #   #   #   #   #   #     # # # #   # # #       # #     #   #
# ### ##### # ### # ####### # ##### # ### ### # # # ##### # ####### # # ### # # #
#   #   # # #     #   #   # # #     # #   #   # # #     #   #   # # # #   # # # #
####### # # # ####### # ### # # # ### # ### ### # ##### ##### # # # ####### # ###
#     # #     #     # #   #   # #   #     #   #   #   # #     #   # #       #   #
# ##### # ####### ### ### ##### ### ####### ### ##### # # ####### ### ######### #
#       #         #   #     # # #           #         #   #   #   #   #       # #
################# # ### ### # # ############# # # # ####### # # ### ### # ##### #
#         # #     # #   # # #             #   # # #       # # #   #     #       #
# ####### # # # ### # ### # # ######### # # ### ########### ##### ############# #
# #   #   #   #   # #     #   #   #   # # #   #       #   #     #       #     # #
# # # # ######### # ########### # # ### ### # ####### # # ##### ### ### # ### # #
#   # #   #     # #         #   # #     #   # #     # # #       #   #   #   # # #
##### ### # ### # ######### # ### ####### ##### ##### # ##### ### ######### # # #
#   #   #     #   #   #   # #   # #     # #             #   # # # #   #     #   #
# ##### ##### ##### # # # # ##### # ### # ############### ### # # # # # ### #####
#   #   #   #       # # #         #   # # #   # #     # #   # # #   #     #     #
### # ### # ######### # ############# ### # # # # ### # # # # # ############### #
#   # #   # #   #     #   #       #     # # # #   #   # # #     #   #     #   # M
# ### # ### # # ####### # # ##### # ### # # # # # # ### # ####### # # ### # # # #
#     #   #   #         #   #     #   #     #   # #     #         # #   #   #   #
#################################################################################