##############################
#M                           #
############################ #
#                            #
# #                   #### ###
# #                   #      #
# #                          #
# ########################## #
#                            #
#          c                 #
#                            #
#                            #
#                            #
#                            #
#                            #
#                            #
#                            #
#                            #
#                            #
#                           C#
##############################