###############################################
#                                             #
#                                             #
#                                             #
#                                             #
#                                             #
#                                             #
#                    M                        #
#                                             #
#                                             #
#                    c                        #
#                                             #
#                                             #
#                                             #
#                                             #
#                                             #
#                          C                  #
#                                             #
#                                             #
###############################################