#########################################
#     #     #       #       #           #
# ### # ##### ##### # ##### # ######### #
# # # # #   # # #     #     # #   #   # #
# # # # # # # # # ########### # ### # # #
# # #     # #   #   #   # #   #     #   #
# # ####### ####### # # # # # ###########
# #     #   #     # # # #   #           #
C # # # # ### ### # # # ### # ####### # M
#   # # # #   #   #   # # # #       # # #
##### # # # ### ### ##### # ####### ### #
# #   # #   #   #       #     #     #   #
# # ### ### ##### ##### ####### ##### # #
# #   # # #     c   # #       #     # # #
# ### # # ######### # ####### ##### # ###
#   # # #         # #   #     #   # #   #
# # # # ####### # # # # # ### # # # ### #
# # # # #       #   # # #   #   # # #   #
# # # # # ####### ##### # ####### ### ###
# #   # #       #       #       #       #
#########################################
