#########################
# #         # #       # # 
# # ### ### # ### # # # #
# # #   # # #     # #   #
C # # ### # # ##### ### #
#   #   #   # #       # #
# ##### # ### # ####### #
#     # # # # #       # #
##### # # # # # ####### M
#     # #   # #   #     #
# ##### ##### ### # ### #
#     #   c     #   #   #
#########################
