#####################
#M                  #
#                   #
#                   #
#                   #
#                   #
#                   #
#                   #
#                   #
#          c        #
#                   #
#                   #
#                   #
#                   #
#                   #
#                   #
#                   #
#                   #
#                   #
#                  C#
#####################