##############################
#M                           #
############################ #
#                            #
# ############################
#                            #
############################ #
#                            #
# ############################
#                            #
############################ #
#               c            #
# ############################
#                            #
############################ #
#                            #
# ############################
#                           C#
##############################