###############################################
#                                             #
#                                             #
#                                             #
#                                             #
#                                             #
#                                             #
#                    M                        #
#                                             #
#                                             #
#                    c                        #
#                                             #
#                                             #
#                                             #
############################################# #
# #############################################
#                          C                  #
############################################# #
#                                             #
###############################################