##############################
#            M               #
############################ #
#                            #
# ############################
#                            #
############################ #
#                            #
# ############################
#                            #
############################ #
#               c            #
# ############################
#                            #
############################ #
#                            #
# ############################
#           C                #
##############################